.
.
. #
. #
. # . # # #
. # . . . #
. # # # . #
. . . # . .
. . . # # #
