.
. . s50
. #
. #
. # .   # # #
. # .   . . #
. # #   # . #
. . .   # . .
. . .   # # #
